id: u d l r
1:  1 1 2 1
2:  2 2 3 1
3:  3 4 3 2
4:  3 4 4 4
