id: u d l r
1:  1 1 2 1
2:  2 2 3 1
3:  3 6 3 2
4:  7 4 4 5
5:  5 5 4 1
6:  3 6 6 7
7:  7 4 7 6
