##############..##########
#........................#
#........................#
#.......xxxxxx.x..........
#.......x......x.........#
#.......x......x.........#
#.......xxxxxxxx.........#
#........................#
#...b....................#
#...........x............#
#........................#
#........................#
#........................#
#........................#
##########################
