##############..##########
#.........b..............#
#...b...........b........#
#.......xxxxxx.x.........#
#...b...x......x....b....#
#.......x................#
#.......xx...............#
#........................#
#...b........b......b....#
#........................#
#........................#
#........................#
#................c.......#
#........................#
##########################
