##########################
#........................#
#........................#
.........................#
...................b.....#
##########...............#
###########..............#
#........##..............#
#.........##.............#
#..........##............#
#..c.....................#
#........................#
######...................#
######...................#
##########################
