##############..##########
#........................#
#........................#
#.......x......x..........
#.........................
#........................#
#........................#
#........................#
#........................#
#...........x............#
#........................#
#........................#
.........................#
.........................#
####..####################
