##########################
#................#.......#
...........xx....#...x...#
.................#......c.
####...............b......
#......................###
#.........b..............#
#........................#
#........................#
#....xx..................#
#........................#
#........................#
#........................#
#........................#
#xxxxxxxxxxxxxxxxxxxxxxxx#
