########xxxxxxxxxxx#######
#..........xx............x
....c....................#
..#.................##...#
#####......bb............#
##x.............x........#
##x.....xxxxxx......bb...#
##xx....xx...............#
###xxxxxxx....x..........#
########xx........xxx....#
#######xx................#
######...........b.......#
#..b.....n...............#
#...............######...#
##...##xxxxxxxxxxxxxxxxxx#
