##########################
#........................#
#........................#
#.......x......x.........#
#........................#
#........................#
#........................#
#........................#
#........................#
#...........x............#
#........................#
#........................#
#........................#
#........................#
##########################
