##########################
#................#.......#
#.......b..x.....#.......#
#.....x..........#......c.
#.....x..........#........
#.....x..........#.....###
#.....x...b......#.......#
#.....x..........#.......#
#.....x..........#.......#
x.....x......b...#.......#
x.....x..........#.......#
#.....x....x.............#
#.....x..........b.......#
#.....x..................#
#x..xxxxxxxxxxxxxxxxxxxxx#
