##########################
#........................#
..........................
..........b.....b.........
#.........b.....b........#
#.........b.....b........#
#.........b.....b........#
#........................#
#......x...........x.....#
#.......xxxxxxxxxxx......#
#........................#
#........................#
.......................c..
..........................
###########....###########
