########xxxxxxxxxxx#######
#........................x
.c.......................x
.................#.......x
##............x..........x
.....................b...x
x..x......#.....x....#...x
x............b...........x
x..................x.....x
x............x...........x
xxx#xxx..................x
x................#....#..x
x.....b......x...........x
x........................x
xx...xxxx##xxxxxxxxxxxxxxx
